11111111111
1C00E0000P1
10000000001
10000000001
10000000001
10000000101
11111111111
